9 2 9 2 9 1 9 1 9 1 9 2 9 1 9 2 9 1 9 1 9 1 9 1 9 1 9 1 9 1 9 1 9 2 9 1 9 1 9 2 9 1 9 1 9 2 9 1 9 1 
1 0 1 0 1 0 2 0 1 0 1 0 1 0 1 0 1 0 1 0 1 0 1 0 1 0 2 0 1 0 2 0 1 0 2 0 1 0 1 0 1 0 2 0 1 0 2 0 2 0 
9 2 9 2 9 2 9 1 9 1 9 1 9 1 9 1 9 2 9 1 9 1 9 1 9 1 9 1 9 2 9 1 9 1 9 1 9 2 9 1 9 1 9 1 9 1 9 1 9 1 
1 0 1 0 1 0 1 0 1 0 1 0 1 0 1 0 1 0 1 0 1 0 1 0 2 0 2 0 1 0 1 0 1 0 2 0 2 0 1 0 1 0 1 0 1 0 2 0 1 0 
9 1 9 1 9 2 9 1 9 1 9 1 9 2 9 1 9 1 9 1 9 1 9 1 9 1 9 1 9 1 9 1 9 2 9 2 9 1 9 1 9 1 9 1 9 1 9 2 9 1 
2 0 2 0 1 0 1 0 1 0 2 0 1 0 1 0 1 0 1 0 1 0 1 0 1 0 1 0 2 0 2 0 1 0 1 0 1 0 2 0 2 0 2 0 1 0 1 0 1 0 
9 1 9 1 9 2 9 1 9 1 9 1 9 1 9 1 9 1 9 2 9 2 9 1 9 1 9 1 9 1 9 1 9 2 9 1 9 1 9 1 9 1 9 2 9 1 9 1 9 1 
2 0 1 0 1 0 1 0 1 0 1 0 1 0 1 0 1 0 1 0 1 0 1 0 1 0 1 0 1 0 1 0 1 0 2 0 1 0 2 0 2 0 1 0 1 0 1 0 2 0 
9 1 9 1 9 2 9 1 9 1 9 1 9 1 9 2 9 1 9 2 9 1 9 1 9 2 9 1 9 1 9 1 9 1 9 1 9 1 9 1 9 1 9 1 9 2 9 1 9 1 
1 0 1 0 1 0 1 0 2 0 2 0 1 0 2 0 1 0 2 0 1 0 1 0 1 0 1 0 1 0 1 0 1 0 2 0 2 0 2 0 1 0 1 0 1 0 2 0 2 0 
9 1 9 1 9 1 9 1 9 1 9 1 9 2 9 2 9 1 9 1 9 1 9 2 9 1 9 2 9 1 9 1 9 1 9 1 9 1 9 1 9 1 9 2 9 1 9 1 9 2 
2 0 2 0 2 0 1 0 1 0 1 0 1 0 2 0 1 0 1 0 2 0 2 0 2 0 1 0 1 0 1 0 1 0 2 0 1 0 1 0 2 0 2 0 1 0 2 0 1 0 
9 1 9 1 9 2 9 1 9 1 9 1 9 2 9 1 9 1 9 1 9 1 9 1 9 1 9 1 9 1 9 1 9 1 9 2 9 1 9 1 9 1 9 1 9 1 9 1 9 2 
1 0 1 0 1 0 1 0 2 0 2 0 2 0 1 0 1 0 1 0 1 0 2 0 1 0 1 0 2 0 2 0 1 0 1 0 1 0 1 0 2 0 1 0 1 0 1 0 2 0 
9 1 9 1 9 2 9 1 9 1 9 1 9 2 9 2 9 2 9 1 9 1 9 1 9 1 9 1 9 1 9 2 9 1 9 2 9 1 9 1 9 1 9 1 9 2 9 2 9 1 
2 0 1 0 1 0 1 0 1 0 1 0 1 0 2 0 1 0 1 0 2 0 2 0 1 0 1 0 1 0 2 0 1 0 2 0 2 0 1 0 1 0 1 0 2 0 2 0 2 0 
9 1 9 1 9 1 9 1 9 2 9 1 9 1 9 1 9 2 9 1 9 1 9 1 9 2 9 1 9 1 9 1 9 1 9 1 9 1 9 2 9 2 9 1 9 1 9 2 9 2 
2 0 2 0 1 0 2 0 1 0 2 0 1 0 2 0 1 0 1 0 1 0 1 0 1 0 1 0 1 0 1 0 2 0 2 0 1 0 1 0 2 0 1 0 1 0 2 0 2 0 
9 1 9 1 9 1 9 1 9 1 9 1 9 1 9 2 9 1 9 2 9 2 9 1 9 1 9 1 9 1 9 1 9 1 9 1 9 1 9 1 9 2 9 1 9 2 9 1 9 1 
1 0 2 0 1 0 2 0 1 0 1 0 2 0 2 0 1 0 2 0 1 0 2 0 1 0 1 0 1 0 1 0 2 0 1 0 1 0 1 0 1 0 2 0 1 0 1 0 1 0 
9 1 9 1 9 2 9 1 9 1 9 1 9 1 9 1 9 2 9 2 9 2 9 1 9 1 9 1 9 2 9 1 9 1 9 1 9 1 9 1 9 1 9 1 9 1 9 2 9 1 
1 0 2 0 1 0 1 0 1 0 1 0 2 0 1 0 1 0 1 0 2 0 1 0 1 0 2 0 2 0 1 0 2 0 2 0 1 0 2 0 1 0 2 0 1 0 2 0 2 0 
9 1 9 1 9 1 9 2 9 1 9 1 9 1 9 1 9 1 9 1 9 2 9 1 9 1 9 2 9 1 9 2 9 2 9 1 9 1 9 1 9 2 9 1 9 1 9 1 9 1 
1 0 1 0 1 0 1 0 1 0 1 0 1 0 1 0 1 0 1 0 1 0 1 0 1 0 1 0 1 0 2 0 1 0 2 0 1 0 1 0 1 0 1 0 1 0 1 0 1 0 
9 1 9 1 9 1 9 1 9 1 9 2 9 1 9 1 9 1 9 2 9 2 9 1 9 1 9 1 9 1 9 2 9 1 9 1 9 1 9 1 9 2 9 1 9 1 9 1 9 1 
1 0 2 0 2 0 1 0 1 0 1 0 1 0 2 0 1 0 1 0 2 0 2 0 2 0 1 0 1 0 1 0 1 0 1 0 2 0 2 0 2 0 1 0 1 0 1 0 1 0 
9 1 9 1 9 1 9 1 9 1 9 1 9 1 9 1 9 1 9 1 9 2 9 2 9 1 9 1 9 1 9 1 9 1 9 2 9 2 9 1 9 1 9 1 9 2 9 1 9 1 
1 0 1 0 1 0 1 0 2 0 1 0 1 0 1 0 1 0 1 0 1 0 2 0 2 0 1 0 2 0 1 0 2 0 1 0 1 0 1 0 1 0 1 0 1 0 1 0 1 0 
9 1 9 1 9 2 9 1 9 1 9 2 9 1 9 1 9 1 9 2 9 1 9 2 9 1 9 2 9 1 9 1 9 1 9 1 9 1 9 1 9 2 9 2 9 1 9 1 9 1 
1 0 1 0 2 0 1 0 1 0 2 0 2 0 1 0 1 0 1 0 1 0 1 0 1 0 1 0 1 0 1 0 1 0 1 0 1 0 1 0 1 0 1 0 1 0 1 0 2 0 
9 1 9 2 9 1 9 1 9 1 9 2 9 2 9 2 9 1 9 1 9 1 9 1 9 2 9 1 9 1 9 1 9 1 9 2 9 1 9 1 9 1 9 2 9 1 9 1 9 1 
1 0 1 0 1 0 1 0 1 0 1 0 2 0 1 0 1 0 1 0 2 0 1 0 2 0 1 0 1 0 2 0 1 0 1 0 2 0 1 0 2 0 2 0 1 0 2 0 2 0 
9 1 9 2 9 1 9 1 9 2 9 2 9 1 9 1 9 2 9 1 9 1 9 1 9 1 9 1 9 1 9 1 9 1 9 1 9 1 9 1 9 1 9 1 9 1 9 1 9 1 
1 0 1 0 2 0 2 0 1 0 2 0 2 0 1 0 1 0 2 0 1 0 1 0 1 0 1 0 1 0 1 0 1 0 1 0 2 0 1 0 1 0 2 0 2 0 1 0 1 0 
9 1 9 2 9 1 9 2 9 1 9 1 9 1 9 1 9 2 9 1 9 1 9 1 9 1 9 2 9 2 9 1 9 1 9 1 9 2 9 1 9 2 9 1 9 1 9 1 9 2 
1 0 1 0 1 0 1 0 1 0 1 0 1 0 1 0 2 0 2 0 1 0 1 0 1 0 1 0 1 0 1 0 2 0 1 0 2 0 1 0 1 0 1 0 2 0 2 0 2 0 
9 1 9 1 9 1 9 1 9 2 9 2 9 1 9 1 9 1 9 2 9 1 9 1 9 1 9 1 9 1 9 1 9 2 9 2 9 1 9 1 9 1 9 2 9 2 9 1 9 2 
1 0 1 0 1 0 1 0 2 0 2 0 1 0 1 0 1 0 2 0 2 0 1 0 1 0 1 0 1 0 1 0 1 0 1 0 1 0 1 0 1 0 1 0 1 0 1 0 1 0 
9 1 9 1 9 1 9 1 9 2 9 1 9 1 9 2 9 2 9 1 9 1 9 1 9 1 9 1 9 2 9 1 9 2 9 1 9 1 9 1 9 2 9 1 9 1 9 1 9 1 
1 0 1 0 1 0 1 0 1 0 1 0 1 0 1 0 1 0 1 0 1 0 1 0 2 0 1 0 1 0 1 0 1 0 1 0 1 0 1 0 1 0 1 0 1 0 1 0 2 0 
9 1 9 1 9 2 9 1 9 1 9 1 9 2 9 1 9 1 9 1 9 1 9 1 9 1 9 2 9 1 9 1 9 1 9 1 9 1 9 1 9 1 9 1 9 1 9 1 9 1 
1 0 1 0 1 0 1 0 1 0 1 0 1 0 1 0 2 0 2 0 1 0 1 0 2 0 1 0 1 0 2 0 1 0 1 0 1 0 1 0 1 0 2 0 1 0 1 0 1 0 
9 1 9 2 9 1 9 1 9 1 9 1 9 1 9 2 9 2 9 2 9 1 9 2 9 1 9 2 9 1 9 1 9 1 9 1 9 1 9 1 9 1 9 1 9 1 9 1 9 1 
1 0 1 0 1 0 1 0 1 0 1 0 1 0 1 0 1 0 1 0 2 0 2 0 1 0 1 0 1 0 1 0 1 0 1 0 1 0 1 0 1 0 1 0 1 0 1 0 1 0 
9 1 9 2 9 1 9 1 9 1 9 1 9 2 9 1 9 1 9 1 9 2 9 1 9 1 9 2 9 1 9 2 9 2 9 1 9 1 9 1 9 2 9 1 9 1 9 1 9 1 
2 0 1 0 1 0 1 0 1 0 1 0 2 0 2 0 1 0 2 0 1 0 1 0 2 0 1 0 1 0 1 0 2 0 1 0 1 0 1 0 2 0 1 0 1 0 1 0 1 0 
9 1 9 1 9 1 9 2 9 2 9 1 9 1 9 1 9 2 9 1 9 1 9 1 9 1 9 1 9 2 9 1 9 1 9 1 9 1 9 1 9 1 9 1 9 1 9 2 9 1 
1 0 2 0 1 0 1 0 2 0 1 0 1 0 1 0 1 0 2 0 2 0 1 0 1 0 1 0 1 0 2 0 1 0 1 0 1 0 1 0 1 0 2 0 1 0 1 0 2 0 
9 1 9 1 9 1 9 2 9 1 9 1 9 1 9 1 9 1 9 1 9 1 9 1 9 1 9 2 9 1 9 1 9 1 9 1 9 1 9 1 9 1 9 2 9 1 9 1 9 1 
2 0 1 0 1 0 2 0 2 0 1 0 1 0 1 0 1 0 1 0 1 0 1 0 1 0 1 0 1 0 1 0 2 0 1 0 1 0 1 0 1 0 1 0 2 0 1 0 1 0 
